OEDV|Osage Exploration and Development, Inc.
AAPL|Apple Inc.
BAC|Bank of America Corporation
AMZN|Amazon.com, Inc.
T|AT&T Inc.
GOOG|Alphabet Inc.
MO|Altria Group, Inc.
DAL|Delta Air Lines, Inc.
AA|Alcoa Corporation
AXP|American Express Company
DD|E. I. du Pont de Nemours and Company
BABA|Alibaba Group Holding Limited
ABT|Abbott Laboratories
UA|Under Armour, Inc.
AMAT|Applied Materials, Inc.
AMGN|Amgen Inc.
AAL|American Airlines Group Inc.
AIG|American International Group, Inc.
ALL|The Allstate Corporation
ADBE|Adobe Systems Incorporated
GOOGL|Alphabet Inc.
ACN|Accenture plc
ABBV|AbbVie Inc.
MT|ArcelorMittal
LLY|Eli Lilly and Company
AGN|Allergan plc
APA|Apache Corporation
ADP|Automatic Data Processing, Inc.
APC|Anadarko Petroleum Corporation
AKAM|Akamai Technologies, Inc.
NLY|Annaly Capital Management, Inc.
ABX|Barrick Gold Corporation
ATVI|Activision Blizzard, Inc.
ADSK|Autodesk, Inc.
ADM|Archer-Daniels-Midland Company
BMH.AX|Baumart Holdings Limited
WBA|Walgreens Boots Alliance, Inc.
ARNA|Arena Pharmaceuticals, Inc.
LUV|Southwest Airlines Co.
ACAD|ACADIA Pharmaceuticals Inc.
PANW|Palo Alto Networks, Inc.
AMD|Advanced Micro Devices, Inc.
AET|Aetna Inc.
AEP|American Electric Power Company, Inc.
ALXN|Alexion Pharmaceuticals, Inc.
CLMS|Calamos Asset Management Inc.
AVGO|Broadcom Limited
EA|Electronic Arts Inc.
DB|Deutsche Bank Aktiengesellschaft
RAI|Reynolds American Inc.
AEM|Agnico Eagle Mines Limited
APD|Air Products and Chemicals, Inc.
AMBA|Ambarella, Inc.
NVS|Novartis AG
APOL|Apollo Education Group, Inc.
ANF|Abercrombie & Fitch Co.
LULU|Lululemon Athletica Inc.
RAD|Rite Aid Corporation
BRK.AX|Brookside Energy Limited
ARRY|Array BioPharma Inc.
AGNC|AGNC Investment Corp.
JBLU|JetBlue Airways Corporation
A|Agilent Technologies, Inc.
ORLY|O'Reilly Automotive, Inc.
FOLD|Amicus Therapeutics, Inc.
AZO|AutoZone, Inc.
ATML|Atmel Corporation
AN|AutoNation, Inc.
AZN|AstraZeneca PLC
AES|The AES Corporation
GAS|AGL Resources Inc.
BUD|Anheuser-Busch InBev SA/NV
ARR|ARMOUR Residential REIT, Inc.
BDX|Becton, Dickinson and Company
AKS|AK Steel Holding Corporation
AB|AllianceBernstein Holding L.P.
ACOR|Acorda Therapeutics, Inc.
CS|Credit Suisse Group AG
AFL|Aflac Incorporated
ADI|Analog Devices, Inc.
AEGR|Aegerion Pharmaceuticals, Inc.
ACIW|ACI Worldwide, Inc.
AMP|Ameriprise Financial, Inc.
AVP|Avon Products, Inc.
AMTD|TD Ameritrade Holding Corporation
AEO|American Eagle Outfitters, Inc.
AWK|American Water Works Company, Inc.
NVO|Novo Nordisk A/S
ALTR|Altera Corp.
ALK|Alaska Air Group, Inc.
PAA|Plains All American Pipeline, L.P.
MTU.AX|M2 Group Ltd
ARCC|Ares Capital Corporation
AAP|Advance Auto Parts, Inc.
NAT|Nordic American Tankers Limited
FNMA|Federal National Mortgage Association
FAV|First Trust Dividend and Income Fund
AIV|Apartment Investment and Management Company
AGIO|Agios Pharmaceuticals, Inc.
AEE|Ameren Corporation
UBS|UBS Group AG
AVXL|Anavex Life Sciences Corp.
ARLP|Alliance Resource Partners, L.P.
ANTM|Anthem, Inc.
AGU|Agrium Inc.
AG|First Majestic Silver Corp.
AFSI|AmTrust Financial Services, Inc.
ABC|AmerisourceBergen Corporation
STO|Statoil ASA
ATI|Allegheny Technologies Incorporated
ADT|The ADT Corporation
AVB|AvalonBay Communities, Inc.
ATW|Atwood Oceanics, Inc.
ALNY|Alnylam Pharmaceuticals, Inc.
LH|Laboratory Corporation of America Holdings
AVY|Avery Dennison Corporation
AUY|Yamana Gold Inc.
ASH|Ashland Global Holdings Inc.
ARMH|ARM Holdings plc
ARIA|ARIAD Pharmaceuticals, Inc.
ANR|Alpha Natural Resources, Inc.
AINV|Apollo Investment Corporation
ACXM|Acxiom Corporation
ACHN|Achillion Pharmaceuticals, Inc.
ACET|Aceto Corporation
ABMD|ABIOMED, Inc.
ABM|ABM Industries Incorporated
VA|Virgin America Inc.
LIFE|aTyr Pharma, Inc.
ATO|Atmos Energy Corporation
ARP|Atlas Resource Partners, L.P.
AON|Aon plc
ADXS|Advaxis, Inc.
ADC|Agree Realty Corporation
APU|AmeriGas Partners, L.P.
SAVE|Spirit Airlines, Inc.
AV|Aviva plc
AKRX|Akorn, Inc.
ADS|Alliance Data Systems Corporation
ABAX|Abaxis, Inc.
AYI|Acuity Brands, Inc.
AWH|Allied World Assurance Company Holdings, AG
ASML|ASML Holding N.V.
AMT|American Tower Corporation
ALDR|Alder Biopharmaceuticals, Inc.
ACM|AECOM
DWA|DreamWorks Animation SKG Inc.
ATRS|Antares Pharma, Inc.
ARW|Arrow Electronics, Inc.
ARI|Apollo Commercial Real Estate Finance, Inc.
ARG|Airgas, Inc.
AR|Antero Resources Corporation
AMCC|Applied Micro Circuits Corporation
AMC|AMC Entertainment Holdings, Inc.
AL|Air Lease Corporation
AGEN|Agenus Inc.
AAN|Aaron's, Inc.
WTR|Aqua America, Inc.
FCAU|Fiat Chrysler Automobiles N.V.
BAH|Booz Allen Hamilton Holding Corporation
AXAS|Abraxas Petroleum Corporation
AVT|Avnet, Inc.
ALB|Albemarle Corporation
AIZ|Assurant, Inc.
SAIC|Science Applications International Corporation
CAR|Avis Budget Group, Inc.
AXLL|Axiall Corporation
AU|AngloGold Ashanti Limited
ARO|Aéropostale, Inc.
APH|Amphenol Corporation
ANTH|Anthera Pharmaceuticals, Inc.
AMX|América Móvil, S.A.B. de C.V.
AMDA|Amedica Corporation
AI|Arlington Asset Investment Corp.
ABCO|The Advisory Board Company
WMC|Western Asset Mortgage Capital Corporation
MPX.AX|Mustera Property Group Limited
JKHY|Jack Henry & Associates, Inc.
AVAV|AeroVironment, Inc.
AMKR|Amkor Technology, Inc.
ALJ|Alon USA Energy, Inc.
ACH|Aluminum Corporation Of China Limited
GPH.AX|Australian Potash Limited
ERC|Wells Fargo Advantage Multi-Sector Income Fund
APPY|Bioptix, Inc.
ANAC|Anacor Pharmaceuticals, Inc.
AEIS|Advanced Energy Industries, Inc.
Y|Alleghany Corporation
MTGE|MTGE Investment Corp.
CENX|Century Aluminum Company
ASPS|Altisource Portfolio Solutions S.A.
AMRN|Amarin Corporation plc
AMPE|Ampio Pharmaceuticals, Inc.
AMAG|AMAG Pharmaceuticals, Inc.
ALKS|Alkermes plc
AFFX|Affymetrix Inc.
ADES|Advanced Emissions Solutions, Inc.
ACAT|Arctic Cat Inc.
AAON|AAON, Inc.
XLRN|Acceleron Pharma Inc.
VRSK|Verisk Analytics, Inc.
VJET|Voxeljet AG
OA|Orbital ATK, Inc.
ATLS|Atlas Energy Group, LLC
APTS|Preferred Apartment Communities, Inc.
APO|Apollo Global Management, LLC
ALSK|Alaska Communications Systems Group, Inc.
ALG|Alamo Group Inc.
AHC|A.H. Belo Corporation
ACTG|Acacia Research Corporation
ACAS|American Capital, Ltd.
RBA|Ritchie Bros. Auctioneers Incorporated
MAA|Mid-America Apartment Communities, Inc.
BAM|Brookfield Asset Management Inc.
ATHN|athenahealth, Inc.
AT|Atlantic Power Corporation
ASX|Advanced Semiconductor Engineering, Inc.
ARCO|Arcos Dorados Holdings Inc.
ANET|Arista Networks, Inc.
ANCX|Access National Corporation
AIR|AAR Corp.
AF|Astoria Financial Corporation
WAB|Westinghouse Air Brake Technologies Corporation
RS|Reliance Steel & Aluminum Co.
PKG|Packaging Corporation of America
CSH|Cash America International, Inc.
AXDX|Accelerate Diagnostics, Inc.
AVHI|AV Homes, Inc.
AVA|Avista Corporation
ATHX|Athersys, Inc.
ARWR|Arrowhead Pharmaceuticals, Inc.
ANGI|Angie's List, Inc.
AMG|Affiliated Managers Group, Inc.
ALSN|Allison Transmission Holdings, Inc.
ALGN|Align Technology, Inc.
AKBA|Akebia Therapeutics, Inc.
AGO|Assured Guaranty Ltd.
AEZS|Aeterna Zentaris Inc.
ACRX|AcelRx Pharmaceuticals, Inc.
ROK|Rockwell Automation Inc.
GLPI|Gaming and Leisure Properties, Inc.
DNI|Dividend and Income Fund
AZZ|AZZ Inc.
ATRC|AtriCure, Inc.
ARRS|ARRIS International plc
ARMK|Aramark
AOS|A. O. Smith Corporation
ANFI|Amira Nature Foods Ltd.
AMID|American Midstream Partners, LP
AMCX|AMC Networks Inc.
ALIM|Alimera Sciences, Inc.
ALE|ALLETE, Inc.
AHT|Ashford Hospitality Trust, Inc.
ACW|Accuride Corp.
ABB|ABB Ltd
AALI.JK|PT Astra Agro Lestari Tbk
SPR|Spirit AeroSystems Holdings, Inc.
SEE|Sealed Air Corporation
RDEN|Elizabeth Arden, Inc.
PAAS|Pan American Silver Corp.
DLPH|Delphi Automotive PLC
ADAC|Adama Technologies Corporation
CBL|CBL & Associates Properties, Inc.
BBVA|Banco Bilbao Vizcaya Argentaria, S.A.
AYR|Aircastle Limited
APOG|Apogee Enterprises, Inc.
ANDE|The Andersons, Inc.
AMSC|American Superconductor Corporation
AMRS|Amyris, Inc.
AMED|Amedisys, Inc.
ALEX|Alexander & Baldwin, Inc.
ALCO|Alico, Inc.
ADUS|Addus HomeCare Corporation
ACTA|Actua Corporation
ACST|Acasti Pharma Inc.
AAWW|Atlas Air Worldwide Holdings, Inc.
WMS|Advanced Drainage Systems, Inc.
PAG|Penske Automotive Group, Inc.
MDRX|Allscripts Healthcare Solutions, Inc.
KLIC|Kulicke and Soffa Industries, Inc.
ETH|Ethan Allen Interiors Inc.
AZPN|Aspen Technology, Inc.
AXE|Anixter International Inc.
ATNY|API Technologies Corp.
APRI|Apricus Biosciences, Inc.
AMH|American Homes 4 Rent
AME|AMETEK, Inc.
AJG|Arthur J. Gallagher & Co.
AIQ|Alliance Healthcare Services, Inc.
AHGP|Alliance Holdings GP, L.P.
AGCO|AGCO Corporation
AERI|Aerie Pharmaceuticals, Inc.
ACRE|Ares Commercial Real Estate Corporation
ABEO|Abeona Therapeutics Inc.
WAL|Western Alliance Bancorporation
SYT|Syngenta AG
SHLM|A. Schulman, Inc.
NOG|Northern Oil and Gas, Inc.
HTA|Healthcare Trust of America, Inc.
GIII|G-III Apparel Group, Ltd.
DAVE|Famous Dave's of America, Inc.
CVU|CPI Aerostructures, Inc.
BSI|Alon Blue Square Israel Ltd
AWAY|HomeAway, Inc.
ATU|Actuant Corporation
ASTI|Ascent Solar Technologies, Inc.
AREX|Approach Resources, Inc.
ARE|Alexandria Real Estate Equities, Inc.
ANSS|Ansys, Inc.
AMNB|American National Bankshares Inc.
AMBS|Amarantus Bioscience Holdings, Inc
ALR|Alere Inc.
AIXG|Aixtron SE
AIN|Albany International Corp.
AHL|Aspen Insurance Holdings Limited
AGX|Argan, Inc.
AEG|AEGON N.V.
ADTN|ADTRAN, Inc.
ADMS|Adamas Pharmaceuticals, Inc.
ACLS|Axcelis Technologies, Inc.
ABG|Asbury Automotive Group, Inc.
ZX|China Zenix Auto International Limited
NXJ|Nuveen New Jersey Quality Municipal Income Fund
KS|KapStone Paper and Packaging Corporation
HOLI|HollySys Automation Technologies, Ltd.
GPI|Group 1 Automotive, Inc.
ENI|Enersis Américas S.A.
BEAV|B/E Aerospace, Inc.
AXTA|Axalta Coating Systems Ltd.
AWR|American States Water Company
AWI|Armstrong World Industries, Inc.
AVEO|AVEO Pharmaceuticals, Inc.
AUO|AU Optronics Corp.
ATHM|Autohome Inc.
ATAX|America First Multifamily Investors, L.P.
ASM|Avino Silver & Gold Mines Ltd.
AROC|Archrock, Inc.
ANH|Anworth Mortgage Asset Corporation
ALX|Alexander's, Inc.
AHS|AMN Healthcare Services Inc.
AGI|Alamos Gold Inc.
AER|AerCap Holdings N.V.
AE|Adams Resources & Energy, Inc.
RHHBY|Roche Holding AG
PETX|Aratana Therapeutics, Inc.
ODC|Oil-Dri Corporation of America
NAO|Nordic American Offshore Ltd.
KAR|KAR Auction Services, Inc.
HUSA|Houston American Energy Corp.
HIVE|Aerohive Networks, Inc.
FMS|Fresenius Medical Care AG & Co. KGAA
DOX|Amdocs Limited
CXW|CoreCivic, Inc.
AZUR|Azure Midstream Partners, LP
AXS|AXIS Capital Holdings Limited
AXL|American Axle & Manufacturing Holdings, Inc.
AWX|Avalon Holdings Corporation
AVID|Avid Technology, Inc.
ASNA|Ascena Retail Group, Inc.
ASGN|On Assignment, Inc.
ARDX|Ardelyx, Inc.
ARAY|Accuray Incorporated
AQXP|Aquinox Pharmaceuticals, Inc.
APT|Alpha Pro Tech, Ltd.
APDN|Applied DNA Sciences, Inc.
AMBC|Ambac Financial Group, Inc.
ALGT|Allegiant Travel Company
ALDW|Alon USA Partners, LP
AIT|Applied Industrial Technologies, Inc.
AIRM|Air Methods Corporation
AIMC|Altra Industrial Motion Corp.
AEL|American Equity Investment Life Holding Company
AEHR|Aehr Test Systems
ADHD|Alcobra Ltd.
ACUR|Acura Pharmaceuticals, Inc.
ACHC|Acadia Healthcare Company, Inc.
ACFC|Atlantic Coast Financial Corporation
ACCO|ACCO Brands Corporation
ABY|Atlantica Yield plc
TA|TravelCenters of America LLC
RPAI|Retail Properties of America, Inc.
MANH|Manhattan Associates, Inc.
LAMR|Lamar Advertising Company
KYN|Kayne Anderson MLP Investment Company
AXN|Aoxing Pharmaceutical Company, Inc.
ATRO|Astronics Corporation
ATNI|ATN International, Inc.
ARCW|ARC Group Worldwide, Inc.
APEI|American Public Education, Inc.
AP|Ampco-Pittsburgh Corporation
ANIK|Anika Therapeutics, Inc.
ANGO|AngioDynamics, Inc.
AMTG|Apollo Residential Mortgage, Inc.
AMSG|AmSurg Corp.
AMOT|Allied Motion Technologies Inc.
AM|Antero Midstream Partners LP
ALV|Autoliv, Inc.
ALOG|Analogic Corporation
AKR|Acadia Realty Trust
AEGN|Aegion Corporation
ADS.DE|Adidas AG
ZLTQ|ZELTIQ Aesthetics, Inc.
WRLD|World Acceptance Corporation
UHAL|AMERCO
UAMY|United States Antimony Corporation
SAH|Sonic Automotive, Inc.
RJET|Republic Airways Holdings Inc.
NAII|Natural Alternatives International, Inc.
AQNM|Aquentium, Inc.
CAS|A.M. Castle & Co.
CACC|Credit Acceptance Corporation
ATSG|Air Transport Services Group, Inc.
ASEI|American Science & Engineering Inc.
ASB|Associated Banc-Corp
ARTX|Arotech Corporation
AROW|Arrow Financial Corporation
ARCB|ArcBest Corporation
AMRK|A-Mark Precious Metals, Inc.
ALRM|Alarm.Com Holdings, Inc.
AHP|Ashford Hospitality Prime, Inc.
AGRX|Agile Therapeutics, Inc.
AFAM|Almost Family, Inc.
ADK|AdCare Health Systems, Inc.
ACSF|American Capital Senior Floating, Ltd.
ABTL|Autobytel Inc.
ABGB|Abengoa SA
ABEV|Ambev S.A.
ABCD|Cambium Learning Group, Inc.
AAOI|Applied Optoelectronics, Inc.
USAP|Universal Stainless & Alloy Products Inc
STFC|State Auto Financial Corporation
STAY|Extended Stay America, Inc.
SEED|Origin Agritech Limited
RGA|Reinsurance Group of America, Incorporated
IDSA|Industrial Services of America, Inc.
HART|Harvard Apparatus Regenerative Technology, Inc.
CH|Aberdeen Chile Fund, Inc.
CEA|China Eastern Airlines Corporation Limited
BREW|Craft Brew Alliance, Inc.
AXR|AMREP Corporation
AVG|AVG Technologies N.V.
AVD|American Vanguard Corporation
AUDC|AudioCodes Ltd.
ATRI|Atrion Corporation
ATOS|Atossa Genetics Inc.
ARC|ARC Document Solutions, Inc.
APIC|Apigee Corporation
AOSL|Alpha and Omega Semiconductor Limited
AOI|Alliance One International, Inc.
AMWD|American Woodmark Corporation
ALXA|Alexza Pharmaceuticals Inc.
ALLY|Ally Financial Inc.
AIRI|Air Industries Group
AFOP|Alliance Fiber Optic Products Inc.
ACGL|Arch Capital Group Ltd.
ACFN|Acorn Energy, Inc.
ABR|Arbor Realty Trust, Inc.
ABCB|Ameris Bancorp
SAMG|Silvercrest Asset Management Group Inc.
REXI|Resource America, Inc.
RAIL|FreightCar America, Inc.
NSAM|Northstar Asset Management Group Inc.
MITT|AG Mortgage Investment Trust, Inc.
LCM|Advent/Claymore Enhanced Growth & Income Fund
HASI|Hannon Armstrong Sustainable Infrastructure Capital, Inc.
GOL|GOL Linhas AÃ©reas Inteligentes S.A.
GIL|Gildan Activewear Inc.
EAD|Wells Fargo Advantage Funds - Wells Fargo Income Opportunities Fund
ATTO|Atento S.A.
ATR|AptarGroup, Inc.
ATNM|Actinium Pharmaceuticals, Inc.
ASTC|Astrotech Corporation
ASR|Grupo Aeroportuario del Sureste, S. A. B. de C. V.
ASC|Ardmore Shipping Corporation
ARTNA|Artesian Resources Corporation
ARGS|Argos Therapeutics, Inc.
AOD|Alpine Total Dynamic Dividend Fund
AGNCP|AGNC Investment Corp.
ADRO|Aduro BioTech, Inc.
ACNB|ACNB Corporation
AAV|Advantage Oil & Gas Ltd.
AAT|American Assets Trust, Inc.
ZNH|China Southern Airlines Company Limited
UAM|Universal American Corp.
NTT|Nippon Telegraph and Telephone Corporation
NFJ|AllianzGI NFJ Dividend, Interest & Premium Strategy Fund
LNT|Alliant Energy Corporation
KALU|Kaiser Aluminum Corporation
HOMB|Home Bancshares, Inc. (Conway, AR)
HIX|Western Asset High Income Fund II Inc.
FAF|First American Financial Corporation
FAC|First Acceptance Corporation
EGT|Entertainment Gaming Asia Inc.
CAAS|China Automotive Systems, Inc.
BGR|BlackRock Energy and Resources Trust
BETR|Amplify Snack Brands, Inc.
AUPH|Aurinia Pharmaceuticals Inc.
ATV|Acorn International, Inc.
ATLC|Atlanticus Holdings Corporation
AST|Asterias Biotherapeutics, Inc.
